Kabul	Afghanistan	KBL
Tirana	Albania	TIA
Algiers	Algeria	ALG
Annaba	Algeria	AAE
Pago Pago, Tutuila	American Samoa	PPG
Benguela	Angola	BUG
Luanda	Angola	LAD
The Valley	Anguilla	AXA
St. John's	Antigua	ANU
Buenos Aires	Argentina	EZE
Cordoba	Argentina	COR
El Calafate	Argentina	FTE
Mendoza	Argentina	MDZ
San Carlos de Bariloche	Argentina	BRC
Santa Rosa	Argentina	RSA
Ushuaia, Tierra del Fuego	Argentina	USH
Yerevan	Armenia	EVN
Oranjestad	Aruba	AUA
Adelaide, S.A.	Australia	ADL
Albury, N.S.W.	Australia	ABX
Alice Springs, N.T.	Australia	ASP
Armidale, N.S.W.	Australia	ARM
Ayers Rock, N.T.	Australia	AYQ
Ballina, N.S.W.	Australia	BNK
Bathurst, N.S.W.	Australia	BHS
Brisbane, Qld.	Australia	BNE
Broken Hill, N.S.W.	Australia	BHQ
Broome, W.A.	Australia	BME
Bundaberg, Qld.	Australia	BDB
Cairns, Qld.	Australia	CNS
Canberra, A.C.T.	Australia	CBR
Ceduna, S.A.	Australia	CED
Charleville, Qld.	Australia	CTL
Coffs Harbour, N.S.W.	Australia	CFS
Coober Pedy, S.A.	Australia	CPD
Darwin, N.T.	Australia	DRW
Devonport, Tas.	Australia	DPO
Dubbo, N.S.W.	Australia	DBO
Emerald, Qld.	Australia	EMD
Gladstone, Qld.	Australia	GLT
Gold Coast, Qld.	Australia	OOL
Gove, N.T.	Australia	GOV
Griffith, N.S.W.	Australia	GFF
Hamilton Island, Whitsunday Island, Qld.	Australia	HTI
Hobart, Tas.	Australia	HBA
Horn Island, Qld.	Australia	HID
Kalgoorlie, W.A.	Australia	KGI
Karratha, W.A.	Australia	KTA
Kingscote, Kangaroo Island, S.A.	Australia	KGC
Karratha, W.A.	Australia	KTA
Longreach, Qld.	Australia	LRE
Launceston, Tas.	Australia	LST
Maroochydore, Qld.	Australia	MCY
Melbourne, Vic.	Australia	MEL
Mount Gambier, S.A.	Australia	MGB
Merimbula, N.S.W.	Australia	MIM
Mackay, Qld.	Australia	MKY
Mildura, Vic.	Australia	MQL
Moree, N.S.W.	Australia	MRZ
Moruya, N.S.W.	Australia	MYA
Narrabri, N.S.W.	Australia	NAA
Narrandera, N.S.W.	Australia	NRA
Newcastle, N.S.W.	Australia	NTL
Orange, N.S.W.	Australia	OAG
Olympic Dam, S.A.	Australia	OLP
Gold Coast, Qld.	Australia	OOL
Paraburdoo, W.A.	Australia	PBO
Perth, W.A.	Australia	PER
Port Hedland, W.A.	Australia	PHE
Parkes, N.S.W.	Australia	PKE
Port Lincoln, S.A.	Australia	PLO
Proserpine, Qld.	Australia	PPP
Port Macquarie, N.S.W.	Australia	PQQ
Portland, Vic.	Australia	PTJ
Roma, Qld.	Australia	RMA
Rockhampton, Qld.	Australia	ROK
Sydney, N.S.W.	Australia	SYD
Tamworth, N.S.W.	Australia	TMW
Townsville, Qld.	Australia	TSV
Weipa, Qld.	Australia	WEI
Wagga-Wagga, N.S.W.	Australia	WGA
Whyalla, S.A.	Australia	WYA
Newman, W.A.	Australia	ZNE
Graz	Austria	GRZ
Innsbruck	Austria	INN
Klagenfurt	Austria	KLU
Linz	Austria	LNZ
Salzburg	Austria	SZG
Vienna	Austria	VIE
Baku	Azerbaijan	BAK
Baku	Azerbaijan	GYD
Ponta Delgada, Sao Miguel Island	Azores	PDL
Angra do Heroismo, Terceira Island	Azores	TER
Andros Town	Bahamas	ASD
North Eleuthera	Bahamas	ELH
Freeport, Grand Bahama Island	Bahamas	FPO
George Town, Great Exuma Island	Bahamas	GGT
Governor's Harbour, Eleuthera Island	Bahamas	GHB
Deadmans Cay, Long Island	Bahamas	LGI
Mangrove Cay, Andros Island	Bahamas	MAY
Marsh Harbour, Abaco Island	Bahamas	MHH
Nassau	Bahamas	NAS
Alice Town, North Bimini Island	Bahamas	NSB
Nassau	Bahamas	PID
Rock Sound	Bahamas	RSD
San Andros	Bahamas	SAQ
Stella Maris, Long Island	Bahamas	SML
Treasure Cay, Abaco Island	Bahamas	TCB
South Andros	Bahamas	TZN
Cockburn Town, San Salvador Island	Bahamas	ZSA
Manama	Bahrain	BAH
Barisal	Bangladesh	BZL
Dhaka	Bangladesh	DAC
Bridgetown	Barbados	BGI
Minsk	Belarus	MHP
Minsk	Belarus	MSQ
Antwerp	Belgium	ANR
Brussels	Belgium	BRU
Belize City	Belize	BZE
Dangriga	Belize	DGA
Placencia	Belize	PLJ
Punta Gorda	Belize	PND
Hamilton	Bermuda	BDA
La Paz	Bolivia	LPB
Kralendijk	Bonaire	BON
Sarajevo	Bosnia and Herzegovina	SJJ
Bauru	Brazil	BAU
Belem	Brazil	BEL
Brasilia	Brazil	BSB
Sao Paulo	Brazil	CGH
Belo Horizonte	Brazil	CNF
Curitiba	Brazil	CWB
Fernando de Noronha	Brazil	FEN
Rio de Janeiro	Brazil	GIG
Sao Paulo	Brazil	GRU
Manaus	Brazil	MAO
Marilia	Brazil	MII
Palmas	Brazil	PMW
Porto Alegre	Brazil	POA
Recife	Brazil	REC
Rio de Janeiro	Brazil	RIO
Sao Paulo	Brazil	SAO
Rio de Janeiro	Brazil	SDU
Sao Jose So Rio Preto	Brazil	SJP
Salvador	Brazil	SSA
Una	Brazil	UNA
Beef Island, Tortola	British Virgin Islands	EIS
Bandar Seri Begawan	Brunei	BWN
Sofia	Bulgaria	SOF
Varna	Bulgaria	VAR
Ouagadougou	Burkina Faso	OUA
Bujumbura	Burundi	BJM
Phnom Penh	Cambodia	PNH
Douala	Cameroon	DLA
Yaounde	Cameroon	NSI
Yaounde	Cameroon	YAO
Anahim Lake, BC	Canada	YAA
Sault Ste. Marie, ON	Canada	YAM
Baie-Comeau, PQ	Canada	YBC
Bagotville, PQ	Canada	YBG
Campbell River, BC	Canada	YBL
Nanaimo, BC	Canada	YCD
Castlegar, BC	Canada	YCG
Deer Lake, NF	Canada	YDF
Edmonton, AB	Canada	YEG
Arviat, NWT	Canada	YEK
Iqaluit, Nunavut	Canada	YFB
Fredericton, NB	Canada	YFC
Flin Flon, MB	Canada	YFO
Kingston, ON	Canada	YGK
Gaspe, PQ	Canada	YGP
Cap-aux-Meules, Magdalens Islands, PQ	Canada	YGR
Dryden, ON	Canada	YHD
Hamilton, ON	Canada	YHM
Halifax, NS	Canada	YHZ
Kamloops, BC	Canada	YKA
Kelowna, BC	Canada	YLW
Fort McMurray, AB	Canada	YMM
Montreal, PQ	Canada	YMQ
Chibougamau, PQ	Canada	YMT
Ottawa, ON	Canada	YOW
Prince Rupert, BC	Canada	YPR
Powell River, BC	Canada	YPW
Quebec, PQ	Canada	YQB
Windsor, ON	Canada	YQG
Kenora, ON	Canada	YQK
Lethbridge, AB	Canada	YQL
Moncton, NB	Canada	YQM
Regina, SK	Canada	YQR
Thunder Bay, ON	Canada	YQT
Grande Prairie, AB	Canada	YQU
Gander, NF	Canada	YQX
Sydney, Cape Breton Island, NS	Canada	YQY
Quesnel, BC	Canada	YQZ
Roberval, PQ	Canada	YRJ
Red Lake, ON	Canada	YRL
Rankin Inlet, NWT	Canada	YRT
Sudbury, ON	Canada	YSB
Saint John, NB	Canada	YSJ
Fort Smith, NWT	Canada	YSM
Thompson, MB	Canada	YTH
Toronto, ON	Canada	YTO
Timmins, ON	Canada	YTS
Toronto, ON	Canada	YTZ
Montreal, PQ	Canada	YUL
Rouyn-Noranda, PQ	Canada	YUY
Val-d'Or, PQ	Canada	YVO
Vancouver, BC	Canada	YVR
Winnipeg, MB	Canada	YWG
Wabush, Labrador, NF	Canada	YWK
Williams Lake, BC	Canada	YWL
Cranbrook, BC	Canada	YXC
Saskatoon, SK	Canada	YXE
Medicine Hat, AB	Canada	YXH
Fort Saint John, BC	Canada	YXJ
Sioux Lookout, ON	Canada	YXL
Prince George, BC	Canada	YXS
Terrace, BC	Canada	YXT
London, ON	Canada	YXU
Abbotsford, BC	Canada	YXX
Whitehorse, YT	Canada	YXY
North Bay, ON	Canada	YYB
Calgary, AB	Canada	YYC
Smithers, BC	Canada	YYD
Fort Nelson, BC	Canada	YYE
Penticton, BC	Canada	YYF
Charlottetown, PEI	Canada	YYG
Victoria, BC	Canada	YYJ
Churchill, MB	Canada	YYQ
St. John's, NF	Canada	YYT
Mont-Joli, PQ	Canada	YYY
Toronto, ON	Canada	YYZ
Yellowknife, NWT	Canada	YZF
Sandspit, Queen Charlotte Islands, BC	Canada	YZP
Sarnia, ON	Canada	YZR
Port Hardy, BC	Canada	YZT
Sept-Iles, PQ	Canada	YZV
Anahim Lake, BC 	Canada 	YAA
Sault Ste. Marie, ON	Canada 	YAM
Baie-Comeau, PQ 	Canada 	YBC
Bagotville, PQ 	Canada 	YBG
Campbell River, BC 	Canada 	YBL
Nanaimo, BC 	Canada 	YCD
Castlegar, BC 	Canada 	YCG
Deer Lake, NF 	Canada 	YDF
Edmonton, AB 	Canada 	YEG
Arviat, NWT	Canada 	YEK
Iqaluit, Nunavut 	Canada 	YFB
Fredericton, NB 	Canada 	YFC
Flin Flon, MB 	Canada 	YFO
Kingston, ON 	Canada 	YGK
Gaspe, PQ 	Canada 	YGP
Cap-aux-Meules, 	Canada 	YGR
Dryden, ON 	Canada 	YHD
Hamilton, ON 	Canada 	YHM
Halifax, NS 	Canada 	YHZ
Kamloops, BC 	Canada 	YKA
Kelowna, BC 	Canada 	YLW
Fort McMurray, AB 	Canada 	YMM
Montreal, PQ 	Canada 	YMQ
Chibougamau, PQ 	Canada 	YMT
Ottawa, ON 	Canada 	YOW
Prince Rupert, BC 	Canada 	YPR
Powell River, BC 	Canada 	YPW
Quebec, PQ 	Canada 	YQB
Windsor, ON 	Canada 	YQG
Kenora, ON 	Canada 	YQK
Lethbridge, AB 	Canada 	YQL
Moncton, NB 	Canada 	YQM
Regina, SK 	Canada 	YQR
Thunder Bay, ON 	Canada 	YQT
Grande Prairie, AB 	Canada 	YQU
Gander, NF 	Canada 	YQX
Sydney, Cape Breton Island, NS	Canada 	YQY
Quesnel, BC 	Canada 	YQZ
Roberval, PQ 	Canada 	YRJ
Red Lake, ON 	Canada 	YRL
Rankin Inlet, NWT	Canada 	YRT
Sudbury, ON 	Canada 	YSB
Saint John, NB 	Canada 	YSJ
Fort Smith, NWT	Canada 	YSM
Thompson, MB 	Canada 	YTH
Toronto, ON 	Canada 	YTO
Timmins, ON 	Canada 	YTS
Toronto, ON 	Canada 	YTZ
Montreal, PQ 	Canada 	YUL
Rouyn-Noranda, PQ 	Canada 	YUY
Val-d'Or, PQ	Canada 	YVO
Vancouver, BC 	Canada 	YVR
Winnipeg, MB 	Canada 	YWG
Wabush, Labrador, NF 	Canada 	YWK
Williams Lake, BC	Canada 	YWL
Cranbrook, BC 	Canada 	YXC
Saskatoon, SK 	Canada 	YXE
Medicine Hat, AB 	Canada 	YXH
Fort Saint John, BC 	Canada 	YXJ
Sioux Lookout, ON	Canada 	YXL
Prince George, BC 	Canada 	YXS
Terrace, BC	Canada 	YXT
London, ON 	Canada 	YXU
Abbotsford, BC 	Canada 	YXX
Whitehorse, YT 	Canada 	YXY
North Bay, ON 	Canada 	YYB
Calgary, AB 	Canada 	YYC
Smithers, BC	Canada 	YYD
Fort Nelson, BC 	Canada 	YYE
Penticton, BC 	Canada 	YYF
Charlottetown, PEI 	Canada 	YYG
Victoria, BC 	Canada 	YYJ
Churchill, MB 	Canada 	YYQ
St. John's, NF 	Canada 	YYT
Mont-Joli, PQ 	Canada 	YYY
Toronto, ON 	Canada 	YYZ
Yellowknife, NWT	Canada 	YZF
Sandspit, Queen Charlotte Islands, BC	Canada 	YZP
Sarnia, ON 	Canada 	YZR
Port Hardy, BC	Canada 	YZT
Sept-Iles, PQ	Canada 	YZV
Arrecife, Lanzarote Island	Canary Islands	ACE
Puerto del Rosario, Fuerteventura Island	Canary Islands	FUE
Las Palmas, Grand Canary Island	Canary Islands	LPA
Tenerife Island	Canary Islands	TCI
Santa Cruz de Tenerife	Canary Islands	TFN
Tenerife Island	Canary Islands	TFS
Tenerife Island	Canary Islands	TVI
Santa Maria, Sal Island	Cape Verde	SID
Cayman Brac	Cayman Islands	CYB
Georgetown, Grand Cayman Island	Cayman Islands	GCM
Bangui	Central African Republic	BGF
N'Djamena	Chad	NDJ
Guernsey	Channel Islands	GCI
Jersey	Channel Islands	JER
Antofagasta	Chile	ANF
Arica	Chile	ARI
Balmaceda	Chile	BBA
Concepcion	Chile	CCP
Copiapo	Chile	CPO
El Salvador	Chile	ESR
Hanga Roa, Easter Island	Chile	IPC
La Serena	Chile	LSC
Puerto Montt	Chile	PMC
Punta Arenas, Tierra del Fuego	Chile	PUQ
Santiago	Chile	SCL
Valdivia	Chile	ZAL
Temuco	Chile	ZCO
Osorno	Chile	ZOS
Pucon	Chile	ZPC
Beijing	China	BJS
Bangda	China	BPX
Guangzhou	China	CAN
Zhengzhou	China	CGO
Changchun	China	CGQ
Chongqing	China	CKG
Changsha	China	CSX
Chengdu	China	CTU
Dalian	China	DLC
Dali City	China	DLU
Dayong	China	DYG
Fuzhou	China	FOC
Haikou, Hainan Island	China	HAK
Hohhot	China	HET
Hefei	China	HFE
Hangzhou	China	HGH
Hong Kong	China	HKG
Hailar	China	HLD
Harbin	China	HRB
Zhoushan	China	HSN
Jiamusi	China	JMU
Songpan Jiuzhai Huanglong	China	JZH
Kashi	China	KHG
Nanchang	China	KHN
Kunming	China	KMG
Guilin	China	KWL
Lanzhou	China	LHW
Lijiang City	China	LJG
Lincang	China	LNJ
Lhasa, Tibet	China	LXA
Mudanjiang	China	MDG
Mian Yang	China	MIG
Ningbo	China	NGB
Nanjing	China	NKG
Nanning	China	NNG
Shanghai	China	PVG
Shanghai	China	SHA
Shenyang	China	SHE
Shijiazhuang	China	SJW
Shantou	China	SWA
Sanya	China	SYX
Shenzhen	China	SZX
Qingdao	China	TAO
Tongren	China	TEN
Tianjin	China	TSN
Taiyuan	China	TYN
Urumqi, Sinkiang	China	URC
Wuhan	China	WUH
Xichang	China	XIC
Xi'an	China	XIY
Xiamen	China	XMN
Yanji	China	YNJ
Yantai	China	YNT
San Andres	Colombia	ADZ
Barranquilla	Colombia	BAQ
Bogota	Colombia	BOG
Cali	Colombia	CLO
Cartagena	Colombia	CTG
Medellin	Colombia	MDE
Moroni	Comoro Islands	HAH
Brazzaville	Congo	BZV
Avarua, Rarotonga Island	Cook Islands	RAR
Liberia	Costa Rica	LIR
San Jose	Costa Rica	SJO
Dubrovnik	Croatia	DBV
Split	Croatia	SPU
Zadar	Croatia	ZAD
Zagreb	Croatia	ZAG
Havana	Cuba	HAV
Willemstad	Curacao	CUR
Larnaca	Cyprus	LCA
Paphos	Cyprus	PFO
Ostrava	Czech Republic	OSR
Prague	Czech Republic	PRG
Aalborg	Denmark	AAL
Aarhus	Denmark	AAR
Billund	Denmark	BLL
Copenhagen	Denmark	CPH
Esbjerg	Denmark	EBJ
Karup	Denmark	KRP
Ronne	Denmark	RNN
Sonderborg	Denmark	SGD
Djibouti	Djibouti	JIB
Roseau	Dominica	DOM
La Romana	Dominican Republic	LRM
Puerto Plata	Dominican Republic	POP
Punta Cana	Dominican Republic	PUJ
Santo Domingo	Dominican Republic	SDQ
Santiago	Dominican Republic	STI
Guayaquil	Ecuador	GYE
Quito	Ecuador	UIO
Alexandria	Egypt	ALY
Aswan	Egypt	ASW
Cairo	Egypt	CAI
Alexandria	Egypt	HBE
Hurghada	Egypt	HRG
Luxor	Egypt	LXR
Sharm El Sheikh	Egypt	SSH
Taba	Egypt	TCP
San Salvador	El Salvador	SAL
Birmingham	England	BHX
Bristol	England	BRS
Doncaster	England	DSA
East Midlands	England	EMA
Humberside	England	HUY
Leeds	England	LBA
London	England	LCY
London	England	LGW
London	England	LHR
London	England	LON
Liverpool	England	LPL
Luton	England	LTN
Manchester	England	MAN
Teesside	England	MME
Newcastle	England	NCL
Norwich	England	NWI
Southampton	England	SOU
London	England	STN
Malabo, Bioko Island	Equatorial Guinea	SSG
Asmara	Eritrea	ASM
Tallinn	Estonia	TLL
Addis Ababa	Ethiopia	ADD
Jijiga	Ethiopia	JIJ
Nadi	Fiji	NAN
Suva	Fiji	SUV
Helsinki	Finland	HEL
Ivalo	Finland	IVL
Joensuu	Finland	JOE
Jyvaskyla	Finland	JYV
Kajaani	Finland	KAJ
Kokkola	Finland	KOK
Kittila	Finland	KTT
Kuopio	Finland	KUO
Mariehamn, Aland	Finland	MHQ
Oulu	Finland	OUL
Rovaniemi	Finland	RVN
Turku	Finland	TKU
Tampere	Finland	TMP
Vaasa	Finland	VAA
Ajaccio, Corsica	France	AJA
Brest	France	BES
Bastia, Corsica	France	BIA
Biarritz	France	BIQ
Bordeaux	France	BOD
Beauvais	France	BVA
Paris	France	CDG
Clermont-Ferrand	France	CFE
Caen	France	CFR
Calvi, Corsica	France	CLY
Mulhouse	France	EAP
Metz	France	ETZ
Figari, Corsica	France	FSC
 Lannion	France	LAI
Lourdes	France	LDE
Le Havre	France	LEH
Limoges	France	LIG
Lille	France	LIL
Lorient	France	LRT
Lyon	France	LYS
Mulhouse	France	MLH
Montpellier	France	MPL
Marseille	France	MRS
Nice	France	NCE
Annecy	France	NCY
Nantes	France	NTE
Paris	France	ORY
Paris	France	PAR
Perpignan	France	PGF
Pau	France	PUF
Rodez	France	RDZ
Rennes	France	RNS
Strasbourg	France	SXB
Toulon	France	TLN
Toulouse	France	TLS
Quimper	France	UIP
Rouen	France	URO
Cayenne	French Guiana	CAY
Ahe	French Polynesia	AHE
Papeete, Tahiti	French Polynesia	PPT
Libreville	Gabon	LBV
Banjul	Gambia	BJL
Tbilisi	Georgia	TBS
Berlin	Germany	BER
Bremen	Germany	BRE
Cologne	Germany	CGN
Dresden	Germany	DRS
Dortmund	Germany	DTM
Dusseldorf	Germany	DUS
Erfurt	Germany	ERF
Friedrichshafen	Germany	FDH
Munster	Germany	FMO
Frankfurt	Germany	FRA
Hannover	Germany	HAJ
Hamburg	Germany	HAM
Hof	Germany	HOQ
Kiel	Germany	KEL
Leipzig	Germany	LEJ
Munich	Germany	MUC
Nuremberg	Germany	NUE
Paderborn	Germany	PAD
Stuttgart	Germany	STR
Berlin	Germany	SXF
Berlin	Germany	THF
Berlin	Germany	TXL
Accra	Ghana	ACC
Athens	Greece	ATH
Alexandroupolis	Greece	AXD
Chania, Crete	Greece	CHQ
Argostoli, Kefalonia Island	Greece	EFL
Heraklion, Crete	Greece	HER
Ioannina	Greece	IOA
Ikaria Island	Greece	JIK
Chios	Greece	JKH
Mikonos	Greece	JMK
Thira, Santorini Island	Greece	JTR
Kos	Greece	KGS
Mytilene, Lesbos Island	Greece	MJT
Rhodes	Greece	RHO
Thessaloniki	Greece	SKG
St. George's	Grenada	GND
Pointe-A-Pitre, Grande-Terre	Guadeloupe	PTP
Agana	Guam	GUM
Flores	Guatemala	FRS
Guatemala City	Guatemala	GUA
Conakry	Guinea	CKY
Bissau	Guinea-Bissau	OXB
Georgetown	Guyana	GEO
Port-au-Prince	Haiti	PAP
Tegucigalpa	Honduras	TGU
Budapest	Hungary	BUD
Balaton	Hungary	SOB
Reykjavik	Iceland	KEF
Reykjavik	Iceland	REK
Reykjavik	Iceland	RKV
Ahmedabad	India	AMD
Bangalore	India	BLR
Mumbai (Bombay)	India	BOM
Calcutta	India	CCU
Delhi	India	DEL
Hyderabad	India	HYD
Chennai (Madras)	India	MAA
Puttaparthi	India	PUT
Varanasi	India	VNS
Biak, Papua	Indonesia	BIK
Balikpapan, Kalimantan	Indonesia	BPN
Jakarta, Java	Indonesia	CGK
Denpasar, Bali	Indonesia	DPS
Jakarta, Java	Indonesia	JKT
Yogyakarta, Java	Indonesia	JOG
Medan, Sumatra	Indonesia	MES
Palembang, Sumatra	Indonesia	PLM
Surabaya, Java	Indonesia	SUB
Ujung Pandang, Sulawesi	Indonesia	UPG
Ardabil	Iran	ADU
Tabriz	Iran	TBZ
Tehran	Iran	THR
Baghdad	Iraq	SDA
Dublin	Ireland	DUB
Connaught	Ireland	NOC
Cork	Ireland	ORK
Shannon	Ireland	SNN
Tel Aviv	Israel	TLV
Alghero, Sardinia	Italy	AHO
Albenga	Italy	ALL
Ancona	Italy	AOI
Aosta	Italy	AOT
Brindisi	Italy	BDS
Bologna	Italy	BLQ
Bari	Italy	BRI
Bolzano	Italy	BZO
Cagliari, Sardinia	Italy	CAG
Rome	Italy	CIA
Crotone	Italy	CRV
Catania, Sicily	Italy	CTA
Florence	Italy	FLR
Genoa	Italy	GOA
Milan	Italy	LIN
Milan	Italy	MIL
Milan	Italy	MXP
Naples	Italy	NAP
Olbia, Sardinia	Italy	OLB
Perugia	Italy	PEG
Palermo, Sicily	Italy	PMO
Pisa	Italy	PSA
Reggio di Calabria	Italy	REG
Rimini	Italy	RMI
Rome	Italy	ROM
Lamezia Terme	Italy	SUF
Turin	Italy	TRN
Trieste	Italy	TRS
Venice	Italy	VCE
Verona	Italy	VRN
Rome	Italy (FCO-Leonardo Da Vinci	FCO
Abidjan	Ivory Coast	ABJ
Kingston	Jamaica	KIN
Kingston	Jamaica	KTP
Montego Bay	Jamaica	MBJ
Ocho Rios	Jamaica	OCJ
Aomori	Japan	AOJ
Naze, Amami-O Island	Japan	ASJ
Akita	Japan	AXT
Sapporo	Japan	CTS
Fukushima	Japan	FKS
Fukuoka	Japan	FUK
Yamagata	Japan	GAJ
Hakodate	Japan	HKD
Tokyo	Japan	HND
Saga	Japan	HSG
Osaka	Japan	ITM
Iwami	Japan	IWJ
Izumo	Japan	IZO
Niigata	Japan	KIJ
Osaka	Japan	KIX
Miyazaki	Japan	KMI
Kumamoto	Japan	KMJ
Komatsu	Japan	KMQ
Kagoshima	Japan	KOJ
Kushiro	Japan	KUH
Memanbetsu	Japan	MMB
Misawa	Japan	MSJ
Matsuyama	Japan	MYJ
Nagoya	Japan	NGO
Nagasaki	Japan	NGS
Nagoya	Japan	NKM
Tokyo	Japan	NRT
Wajima	Japan	NTQ
Obihiro	Japan	OBO
Oita	Japan	OIT
Naha, Okinawa	Japan	OKA
Sapporo	Japan	OKD
Odate Noshiro	Japan	ONJ
Osaka	Japan	OSA
Nanki Shirahama	Japan	SHM
Takamatsu	Japan	TAK
Tokyo	Japan	TYO
Amman	Jordan	AMM
Almaty	Kazakhstan	ALA
Karaganda	Kazakhstan	KGF
Kzyl Orda	Kazakhstan	KZO
Semipalatinsk	Kazakhstan	PLX
Astana	Kazakhstan	TSE
Ust Kamenogorsk	Kazakhstan	UKK
Mombasa	Kenya	MBA
Nairobi	Kenya	NBO
Kuwait	Kuwait	KWI
Bishkek	Kyrgyzstan	FRU
Vientiane	Laos	VTE
Riga	Latvia	RIX
Beirut	Lebanon	BEY
Maseru	Lesotho	MSU
Monrovia	Liberia	ROB
Tripoli	Libya	TIP
Vilnius	Lithuania	VNO
Luxembourg	Luxembourg	LUX
Skopje	Macedonia	SKP
Antananarivo	Madagascar	TNR
Funchal	Madeira	FNC
Porto Santo	Madeira	PXO
Blantyre	Malawi	BLZ
Lilongwe	Malawi	LLW
Alor Setar	Malaysia	AOR
Kota Kinabalu, Sabah	Malaysia	BKI
Bintulu, Sarawak	Malaysia	BTU
Ipoh	Malaysia	IPH
Johor Bahru	Malaysia	JHB
Kota Bharu	Malaysia	KBR
Kuching, Sarawak	Malaysia	KCH
Kuantan	Malaysia	KUA
Kuala Lumpur	Malaysia	KUL
Long Banga	Malaysia	LBP
Lahad Datu, Sabah	Malaysia	LDU
Langkawi	Malaysia	LGK
Miri, Sarawak	Malaysia	MYY
Mulu	Malaysia	MZV
Penang, Penang Island	Malaysia	PEN
Sibu, Sarawak	Malaysia	SBW
Sandakan, Sabah	Malaysia	SDK
Kuala Terengganu	Malaysia	TGG
Tawau, Sabah	Malaysia	TWU
Male	Maldives	MLE
Valletta	Malta	MLA
Majuro	Marshall Islands	MAJ
Fort-de-France	Martinique	FDF
Nouakchott	Mauritania	NKC
Mahebourg	Mauritius	MRU
Acapulco	Mexico	ACA
Aguascalientes	Mexico	AGU
Leon	Mexico	BJX
Ciudad Obregon	Mexico	CEN
Ciudad Juarez	Mexico	CJS
Colima	Mexico	CLQ
Ciudad Del Carmen	Mexico	CME
Campeche	Mexico	CPE
Chetumal	Mexico	CTM
Culiacan	Mexico	CUL
Cancun	Mexico	CUN
Chihuahua	Mexico	CUU
Ciudad Victoria	Mexico	CVM
Cozumel	Mexico	CZM
Durango	Mexico	DGO
Guadalajara	Mexico	GDL
Guaymas	Mexico	GYM
Hermosillo	Mexico	HMO
Jalapa	Mexico	JAL
La Paz	Mexico	LAP
Monclova	Mexico	LOV
Loreto	Mexico	LTO
Lazaro Cardenas	Mexico	LZC
Mexico City	Mexico	MEX
Merida	Mexico	MID
Morelia	Mexico	MLM
Monterrey	Mexico	MTY
Mexicali	Mexico	MXL
Mazatlan	Mexico	MZT
Nuevo Laredo	Mexico	NLD
Oaxaca	Mexico	OAX
Puebla	Mexico	PBC
Piedras Negras	Mexico	PDS
Puerto Vallarta	Mexico	PVR
Puerto Escondido	Mexico	PXM
Queretaro	Mexico	QRO
Reynosa	Mexico	REX
Los Cabos	Mexico	SJD
San Luis Potosi	Mexico	SLP
Saltillo	Mexico	SLW
Tampico	Mexico	TAM
Tapachula	Mexico	TAP
Tuxtla Gutierrez	Mexico	TGZ
Tijuana	Mexico	TIJ
Toluca	Mexico	TLC
Tepic	Mexico	TPQ
Torreon	Mexico	TRC
Veracruz	Mexico	VER
Villahermosa	Mexico	VSA
Zacatecas	Mexico	ZCL
Ixtapa	Mexico	ZIH
Manzanillo	Mexico	ZLO
Kosrae	Micronesia	KSA
Pohnpei	Micronesia	PNI
Truk	Micronesia	TKK
Yap	Micronesia	YAP
Chisinau	Moldova	KIV
Ulan Bator	Mongolia	ULN
Agadir	Morocco	AGA
Casablanca	Morocco	CMN
Nador	Morocco	NDR
Marrakech	Morocco	RAK
Marrakech	Morocco	RAK
Tangier	Morocco	TNG
Maputo	Mozambique	MPM
Rangoon	Myanmar (Burma)	RGN
Kathmandu	Nepal	KTM
Lukla	Nepal	LUA
Amsterdam	Netherlands	AMS
Rotterdam	Netherlands	RTM
Noumea	New Caledonia	GEA
Noumea	New Caledonia	NOU
Auckland	New Zealand	AKL
Blenheim	New Zealand	BHE
Christchurch	New Zealand	CHC
Dunedin	New Zealand	DUD
Gisborne	New Zealand	GIS
Hokitika	New Zealand	HKK
Hamilton	New Zealand	HLZ
Invercargill	New Zealand	IVC
Kaitaia	New Zealand	KAT
Kerikeri	New Zealand	KKE
Napier	New Zealand	NPE
Nelson	New Zealand	NSN
Palmerston North	New Zealand	PMR
Rotorua	New Zealand	ROT
Timaru	New Zealand	TIU
Tauranga	New Zealand	TRG
Taupo	New Zealand	TUO
Wanganui	New Zealand	WAG
Whakatane	New Zealand	WHK
Wellington	New Zealand	WLG
Whangarei	New Zealand	WRE
Westport	New Zealand	WSZ
Queenstown	New Zealand	ZQN
Managua	Nicaragua	MGA
Niamey	Niger	NIM
Abuja	Nigeria	ABV
Ibadan	Nigeria	IBA
Lagos	Nigeria	LOS
Warri	Nigeria	QRW
Pyongyang	North Korea	FNJ
Belfast	Northern Ireland	BFS
Belfast	Northern Ireland	BHD
Londonderry	Northern Ireland	LDY
Saipan	Northern Mariana Islands	SPN
Aalesund	Norway	AES
Alta	Norway	ALF
Bardufoss	Norway	BDU
Bergen	Norway	BGO
Bodo	Norway	BOO
Evenes	Norway	EVE
Haugesund	Norway	HAU
Hammerfest	Norway	HFT
Kristiansand	Norway	KRS
Longyearbyen, Svalbard	Norway	LYR
Narvik	Norway	NVK
Oslo	Norway	OSL
Stavanger	Norway	SVG
Tromso	Norway	TOS
Trondheim	Norway	TRD
Sandefjord	Norway	TRF
Muscat	Oman	MCT
Islamabad-Rawalpindi	Pakistan	ISB
Karachi	Pakistan	KHI
Lahore	Pakistan	LHE
Peshawar	Pakistan	PEW
Koror	Palau	ROR
Panama City	Panama	PTY
Deboyne	Papua-New Guinea	DOY
Port Moresby	Papua-New Guinea	POM
Ciudad del Este	Paraguay	AGT
Asuncion	Paraguay	ASU
Arequipa	Peru	AQP
Cusco	Peru	CUZ
Lima	Peru	LIM
Bacolod	Philippines	BCD
Butuan	Philippines	BXU
Cotabato	Philippines	CBO
Cebu	Philippines	CEB
Cagayan de Oro	Philippines	CGY
Angeles City	Philippines	CRK
Dumaguete	Philippines	DGT
Dipolog	Philippines	DPL
Davao	Philippines	DVO
General Santos	Philippines	GES
Iloilo	Philippines	ILO
Kalibo	Philippines	KLO
Legaspi	Philippines	LGP
Manila	Philippines	MNL
Cubi Point Nas	Philippines	NCP
Puerto Princesa	Philippines	PPS
Roxas City	Philippines	RXS
Subic Bay	Philippines	SFS
Tacloban	Philippines	TAC
Tagbilaran	Philippines	TAG
Zamboanga	Philippines	ZAM
Bydgoszcz	Poland	BZG
Gdansk	Poland	GDN
Krakow	Poland	KRK
Katowice	Poland	KTW
Poznan	Poland	POZ
Rzeszow	Poland	RZE
Szczecin	Poland	SZZ
Warsaw	Poland	WAW
Wroclaw	Poland	WRO
Faro	Portugal	FAO
Lisbon	Portugal	LIS
Porto	Portugal	OPO
Aguadilla	Puerto Rico	BQN
San Juan	Puerto Rico	SJU
Vieques	Puerto Rico	VQS
Doha	Qatar	DOH
Jeju, Korea	Republic of	CJU
Seoul, Korea	Republic of	GMP
Seoul, Korea	Republic of	ICN
Busan, Korea	Republic of	PUS
Yangyang, Korea	Republic of	YNY
Saint-Denis	Reunion	RUN
Saint-Pierre	Reunion	ZSE
Bucharest	Romania	OTP
Arkhangelsk	Russia	ARH
Nizhniy Novgorod	Russia	GOJ
Irkutsk, Siberia	Russia	IKT
Kaliningrad	Russia	KGD
St. Petersburg	Russia	LED
Murmansk	Russia	MMK
Moscow	Russia	MOW
Naryan Mar	Russia	NNM
Omsk, Siberia	Russia	OMS
Novosibirsk, Siberia	Russia	OVB
Petropavlovsk-Kamchatsky, Siberia	Russia	PKC
Rostov	Russia	ROV
Moscow	Russia	SVO
Ekaterinburg, Siberia	Russia	SVX
Moscow	Russia	VKO
Volgograd	Russia	VOG
Vladivostok, Siberia	Russia	VVO
Kigali	Rwanda	KGL
Saba Island	Saba	SAB
Dhahran	Saudi Arabia	DHA
Dawadmi	Saudi Arabia	DWD
Jeddah	Saudi Arabia	JED
Riyadh	Saudi Arabia	RUH
Aberdeen 	Scotland	ABZ
Benbecula	Scotland	BEB
Campbeltown	Scotland	CAL
Edinburgh	Scotland	EDI
Glasgow	Scotland	GLA
Islay Island	Scotland	ILY
Inverness	Scotland	INV
Kirkwall, Orkney Islands	Scotland	KOI
Lerwick, Shetland Islands	Scotland	LSI
Glasgow	Scotland	PIK
Stornoway, Isle of Lewis	Scotland	SYY
Balephuil	Scotland	TRE
Wick	Scotland	WIC
Dakar	Senegal	DKR
Belgrade	Serbia and Montenegro	BEG
Victoria, Mahe Island	Seychelles	SEZ
Freetown	Sierra Leone	FNA
Singapore	Singapore	SIN
Bratislava	Slovakia	BTS
Ljubljana	Slovenia	LJU
Honiara, Guadalcanal	Solomon Islands	HIR
Mogadishu	Somalia	MGQ
Mala Mala	South Africa	AAM
Bloemfontein	South Africa	BFN
Cape Town	South Africa	CPT
Durban	South Africa	DUR
East London	South Africa	ELS
Johannesburg	South Africa	JNB
Nelspruit	South Africa	MQP
Taegu	South Korea	TAE
Malaga	Spain	AGP
Alicante	Spain	ALC
Barcelona	Spain	BCN
Bilbao	Spain	BIO
Badajoz	Spain	BJZ
San Sebastian	Spain	EAS
Granada	Spain	GRX
Ibiza	Spain	IBZ
La Coruna	Spain	LCG
Almeria	Spain	LEI
Leon	Spain	LEN
Madrid	Spain	MAD
Mao, Minorca	Spain	MAH
Murcia	Spain	MJV
Melilla	Spain	MLN
Palma, Mallorca	Spain	PMI
Pamplona	Spain	PNA
Logrono	Spain	RJL
Santander	Spain	SDR
Santa Cruz	Spain	SPC
Seville	Spain	SVQ
Vigo	Spain	VGO
Vitoria	Spain	VIT
Valencia	Spain	VLC
Valladolid	Spain	VLL
Jerez de La Frontera	Spain	XRY
Zaragoza	Spain	ZAZ
Colombo	Sri Lanka	CMB
Gustavia	St. Barts	SBH
Oranjestad	St. Eustatius	EUX
Basseterre	St. Kitts	SKB
Castries	St. Lucia	SLU
Vieux Fort	St. Lucia	UVF
Philipsburg	St. Maarten	SXM
Kingstown	St. Vincent	SVD
Khartoum	Sudan	KRT
Paramaribo	Suriname	PBM
Manzini	Swaziland	MTS
Helsingborg	Sweden	AGH
Arvidsjaur	Sweden	AJR
Stockholm	Sweden	ARN
Borlange	Sweden	BLE
Stockholm	Sweden	BMA
Gothenburg	Sweden	GOT
Halmstad	Sweden	HAD
Hemavan	Sweden	HMV
Jonkoping	Sweden	JKG
Kristianstad	Sweden	KID
Kalmar	Sweden	KLR
Kramfors	Sweden	KRF
Kiruna	Sweden	KRN
Karlstad	Sweden	KSD
Lulea	Sweden	LLA
Linkoping	Sweden	LPI
Lycksele	Sweden	LYC
Malmo	Sweden	MMA
Malmo	Sweden	MMX
Mora	Sweden	MXX
Norrkoping	Sweden	NRK
Ornskoldsvik	Sweden	OER
Orebro	Sweden	ORB
Ostersund	Sweden	OSD
Pajala	Sweden	PJA
Ronneby	Sweden	RNB
Sundsvall	Sweden	SDL
Skelleftea	Sweden	SFT
Storuman	Sweden	SQO
Stockholm	Sweden	STO
Umea	Sweden	UME
Visby	Sweden	VBY
Vilhelmina	Sweden	VHM
Vasteras	Sweden	VST
Vaxjo	Sweden	VXO
Altenrhein	Switzerland	ACH
Berne	Switzerland	BRN
Basel	Switzerland	BSL
Geneva	Switzerland	GVA
Lugano	Switzerland	LUG
Zurich	Switzerland	ZRH
Damascus	Syria	DAM
Hengchun	Taiwan	HCN
Hualien	Taiwan	HUN
Kaohsiung	Taiwan	KHH
Nangen	Taiwan	LZN
Matsu	Taiwan	MFK
Taichung	Taiwan	RMQ
Taipei	Taiwan	TPE
Taipei	Taiwan	TSA
Dushanbe	Tajikistan	DYU
Arusha	Tanzania	ARK
Dar es Salaam	Tanzania	DAR
Zanzibar	Tanzania	ZNZ
Buri Ram	Thailand	BFV
Bangkok	Thailand	BKK
Chiang Rai	Thailand	CEI
Chiang Mai	Thailand	CNX
Hat Yai	Thailand	HDY
Mae Hong Son	Thailand	HGN
Phuket	Thailand	HKT
Krabi	Thailand	KBV
Khon Kaen	Thailand	KKC
Nakhon Si Thammarat	Thailand	NST
Phitsanulok	Thailand	PHS
Trat	Thailand	TDX
Sukhothai	Thailand	THS
Trang	Thailand	TST
Ubon Ratchathani	Thailand	UBP
Ranong	Thailand	UNN
Surat Thani	Thailand	URT
Koh Samui	Thailand	USM
Udon Thani	Thailand	UTH
Utapao	Thailand	UTP
Lome	Togo	LFW
Port of Spain	Trinidad and Tobago	POS
Tobago	Trinidad and Tobago	TAB
Houmt Souk	Tunisia	DJE
Monastir	Tunisia	MIR
Tunis	Tunisia	TUN
Adana	Turkey	ADA
Izmir	Turkey	ADB
Adiyaman	Turkey	ADF
Antalya	Turkey	AYT
Dalaman	Turkey	DLM
Ankara	Turkey	ESB
Istanbul	Turkey	IST
Istanbul	Turkey	SAW
Samsun	Turkey	SZF
Providenciales Island	Turks and Caicos Islands	PLS
Charlotte Amalie, St. Thomas	U.S. Virgin Islands	STT
Christiansted, St. Croix	U.S. Virgin Islands	STX
Entebbe	Uganda	EBB
Dnepropetrovsk	Ukraine	DNK
Donetsk	Ukraine	DOK
Kharkov	Ukraine	HRK
Kiev	Ukraine	KBP
Mariupol	Ukraine	MPW
Odessa	Ukraine	ODS
Lugansk	Ukraine	VSG
Abu Dhabi	United Arab Emirates	AUH
Dubai	United Arab Emirates	DXB
Sharjah	United Arab Emirates	SHJ
Montevideo	Uruguay	MVD
Allentown, PA 	USA 	ABE
Abilene, TX 	USA 	ABI
Albuquerque, NM 	USA 	ABQ
Aberdeen, SD 	USA 	ABR
Albany, GA 	USA 	ABY
Nantucket, MA 	USA 	ACK
Waco, TX 	USA 	ACT
Eureka, CA	USA 	ACV
Atlantic City, NJ 	USA 	ACY
Kodiak, AK 	USA 	ADQ
Alexandria, LA 	USA 	AEX
Augusta, GA 	USA 	AGS
Athens, GA 	USA 	AHN
Alliance, NE 	USA 	AIA
King Salmon, AK	USA 	AKN
Albany, NY 	USA 	ALB
Waterloo, IA 	USA 	ALO
Alamosa, CO 	USA 	ALS
Walla Walla, WA 	USA 	ALW
Amarillo, TX 	USA 	AMA
Anchorage, AK 	USA 	ANC
Altoona, PA 	USA 	AOO
Naples, FL 	USA 	APF
Alpena, MI 	USA 	APN
Watertown, NY 	USA 	ART
Aspen, CO 	USA 	ASE
Atlanta, GA 	USA 	ATL
Appleton, WI 	USA 	ATW
Watertown, SD 	USA 	ATY
Augusta, ME 	USA 	AUG
Austin, TX 	USA 	AUS
Asheville, NC 	USA 	AVL
Wilkes-Barre, PA 	USA 	AVP
Kalamazoo, MI 	USA 	AZO
Burlington, MA 	USA 	BBF
Hartford, CT 	USA 	BDL
Bedford, MA 	USA 	BED
Bethel, AK 	USA 	BET
Scottsbluff, NE 	USA 	BFF
Bakersfield, CA 	USA 	BFL
Binghamton, NY 	USA 	BGM
Bangor, ME 	USA 	BGR
Bar Harbor, ME 	USA 	BHB
Birmingham, AL 	USA 	BHM
Hilo, Hawaii 	USA 	Big
Billings, MT 	USA 	BIL
Bismarck, ND 	USA 	BIS
Bemidji, MN 	USA 	BJI
Beckley, WV 	USA 	BKW
Brookings, SD 	USA 	BKX
Bluefield, WV 	USA 	BLF
Bellingham, WA 	USA 	BLI
Bloomington, IN 	USA 	BMG
Bloomington, IL 	USA 	BMI
Nashville, TN 	USA 	BNA
Boise, ID 	USA 	BOI
Boston, MA 	USA 	BOS
Beaumont, TX 	USA 	BPT
Brunswick, GA 	USA 	BQK
Burlington, IA 	USA 	BRL
Brownsville, TX 	USA 	BRO
Barrow, AK	USA 	BRW
Butte, MT 	USA 	BTM
Baton Rouge, LA 	USA 	BTR
Bettles, AK 	USA 	BTT
Burlington, VT 	USA 	BTV
Buffalo, NY 	USA 	BUF
Burbank, CA 	USA 	BUR
Baltimore, MD 	USA 	BWI
Bozeman, MT 	USA 	BZN
Columbia, SC 	USA 	CAE
Akron, OH 	USA 	CAK
Cordova, AK 	USA 	CDV
Springfield, MA 	USA 	CEF
Cape Girardeau, MO 	USA 	CGI
Chattanooga, TN 	USA 	CHA
Chicago, IL 	USA 	CHI
Charlottesville, VA 	USA 	CHO
Charleston, SC 	USA 	CHS
Chico, CA 	USA 	CIC
Cedar Rapids, IA 	USA 	CID
Sault Ste. Marie, MI	USA 	CIU
Clarksburg, WV 	USA 	CKB
Carlsbad, CA 	USA 	CLD
Cleveland, OH 	USA 	CLE
College Station, TX 	USA 	CLL
Charlotte, NC 	USA 	CLT
Columbus, IN 	USA 	CLU
Columbus, OH 	USA 	CMH
Champaign, IL 	USA 	CMI
Hancock, MI 	USA 	CMX
Carlsbad, NM 	USA 	CNM
Cody, WY 	USA 	COD
Colorado Springs, CO 	USA 	COS
Columbia, MO 	USA 	COU
Casper, WY 	USA 	CPR
Corpus Christi, TX 	USA 	CRP
Charleston, WV 	USA 	CRW
Columbus, GA 	USA 	CSG
Cincinnati, OH 	USA 	CVG
Clovis, NM 	USA 	CVN
Wausau, WI 	USA 	CWA
Cheyenne, WY 	USA 	CYS
Daytona Beach, FL 	USA 	DAB
Dallas, TX 	USA 	DAL
Dayton, OH 	USA 	DAY
Dubuque, IA 	USA 	DBQ
Washington DC 	USA 	DCA
Dodge City, KS 	USA 	DDC
Decatur, IL 	USA 	DEC
Denver, CO 	USA 	DEN
Dallas, TX 	USA 	DFW
Dothan, AL 	USA 	DHN
Dickinson, ND 	USA 	DIK
Dillingham, AK 	USA 	DLG
Duluth, MN 	USA 	DLH
Durango, CO 	USA 	DRO
Des Moines, IA 	USA 	DSM
Detroit, MI 	USA 	DTT
Detroit, MI 	USA 	DTW
Du Bois, PA 	USA 	DUJ
Dutch Harbor, Un Island, AK	USA 	DUT
Devils Lake, ND 	USA 	DVL
Kearney, NE 	USA 	EAR
Wenatchee, WA 	USA 	EAT
Eau Claire, WI 	USA 	EAU
Eek, AK 	USA 	EEK
Houston, TX 	USA 	EFD
Vail, CO 	USA 	EGE
Elko, NV 	USA 	EKO
El Dorado, AR 	USA 	ELD
Elmira, NY 	USA 	ELM
El Paso, TX 	USA 	ELP
Kenai, AK 	USA 	ENA
Erie, PA 	USA 	ERI
Escanaba, MI 	USA 	ESC
Eugene, OR 	USA 	EUG
Evansville, IN 	USA 	EVV
New Bern, NC 	USA 	EWN
Newark, NJ 	USA 	EWR
Key West, FL 	USA 	EYW
Fairbanks, AK 	USA 	FAI
Fargo, ND 	USA 	FAR
Fresno, CA 	USA 	FAT
Fayetteville, NC 	USA 	FAY
Kalispell, MT 	USA 	FCA
Flagstaff, AZ 	USA 	FLG
Fort Lauderdale, FL 	USA 	FLL
Florence, SC 	USA 	FLO
Farmington, NM 	USA 	FMN
Flint, MI 	USA 	FNT
Fort Dodge, IA 	USA 	FOD
Sioux Falls, SD 	USA 	FSD
Fort Smith, AR 	USA 	FSM
Fort Wayne, IN 	USA 	FWA
Fort Yukon, AK 	USA 	FYU
Great Bend, KS 	USA 	GBD
Gillette, WY 	USA 	GCC
Garden City, KS	USA 	GCK
Glendive, MT 	USA 	GDV
Spokane, WA 	USA 	GEG
Grand Forks, ND 	USA 	GFK
Longview, TX 	USA 	GGG
Grand Junction, CO 	USA 	GJT
Greenville, MS 	USA 	GLH
Gainesville, FL 	USA 	GNV
Gulfport, MS 	USA 	GPT
Green Bay, WI 	USA 	GRB
Grand Island, NE 	USA 	GRI
Killeen, TX 	USA 	GRK
Grand Rapids, MI 	USA 	GRR
Greensboro, NC 	USA 	GSO
Greenville, SC 	USA 	GSP
Great Falls, MT 	USA 	GTF
Columbus, MS 	USA 	GTR
Gunnison, CO 	USA 	GUC
Hagerstown, MD 	USA 	HGR
Hilton Head Island, SC 	USA 	HHH
Hibbing, MN 	USA 	HIB
Lake Havasu City, AZ 	USA 	HII
Helena, MT 	USA 	HLN
Honolulu, Oahu, HI	USA 	HNL
Hana, Maui, HI	USA 	HNM
Hobbs, NM 	USA 	HOB
Homer, AK	USA 	HOM
Huron, SD	USA 	HON
Hot Springs, AR 	USA 	HOT
Houston, TX 	USA 	HOU
White Plains, NY 	USA 	HPN
Harlingen, TX 	USA 	HRL
Harrison, AR 	USA 	HRO
Huntsville, AL 	USA 	HSV
Huntington, WV 	USA 	HTS
New Haven, CT 	USA 	HVN
Havre, MT 	USA 	HVR
Hyannis, MA 	USA 	HYA
Hays, KS	USA 	HYS
Washington DC 	USA 	IAD
Houston, TX 	USA 	IAH
Wichita, KS 	USA 	ICT
Idaho Falls, ID 	USA 	IDA
Kingman, AZ 	USA 	IGM
Wilmington, DE 	USA 	ILG
Wilmington, NC 	USA 	ILM
Iron Mountain, MI 	USA 	IMT
Indianapolis, IN 	USA 	IND
International Falls, MN 	USA 	INL
El Centro, CA 	USA 	IPL
Williamsport, PA 	USA 	IPT
Kirksville, MO 	USA 	IRK
Williston, ND 	USA 	ISN
Islip, NY 	USA 	ISP
Ithaca, NY 	USA 	ITH
Ironwood, MI	USA 	IWD
Inyokern, CA 	USA 	IYK
Jackson Hole, WY 	USA 	JAC
Jackson, MS 	USA 	JAN
Jacksonville, FL 	USA 	JAX
Jonesboro, AR 	USA 	JBR
New York, NY 	USA 	JFK
Kapalua, Maui, HI	USA 	JHM
Jamestown, NY 	USA 	JHW
Joplin, MO 	USA 	JLN
Jamestown, ND 	USA 	JMS
Juneau, AK 	USA 	JNU
Johnstown, PA 	USA 	JST
Kailua-Kona, HI	USA 	KOA
Kamuela, Hawaii 	USA 	KOA
Ketchikan, AK 	USA 	KTN
Lansing, MI 	USA 	LAN
Laramie, WY 	USA 	LAR
Las Vegas, NV 	USA 	LAS
Lawton, OK 	USA 	LAW
Los Angeles, CA 	USA 	LAX
Lubbock, TX 	USA 	LBB
Latrobe, PA 	USA 	LBE
North Platte, NE 	USA 	LBF
Liberal, KS	USA 	LBL
Lake Charles, LA 	USA 	LCH
Lebanon, NH 	USA 	LEB
Lewiston, ME 	USA 	LEW
Lexington, KY 	USA 	LEX
Lafayette, LA 	USA 	LFT
New York, NY 	USA 	LGA
Long Beach, CA 	USA 	LGB
Lihue, Kauai, HI	USA 	LIH
Little Rock, AR 	USA 	LIT
Klamath Falls, OR 	USA 	LMT
Lincoln, NE 	USA 	LNK
Lancaster, PA 	USA 	LNS
Lanai City, Lanai, HI	USA 	LNY
Laredo, TX 	USA 	LRD
Las Cruces, NM 	USA 	LRU
La Crosse, WI 	USA 	LSE
Kalaupapa, Molokai, HI	USA 	LUP
Greenbrier, WV	USA 	LWB
Lewiston, ID 	USA 	LWS
Lewistown, MT 	USA 	LWT
Lynchburg, VA 	USA 	LYH
Midland, TX 	USA 	MAF
Manistee, MI 	USA 	MBL
Saginaw, MI 	USA 	MBS
Kansas City, MO 	USA 	MCI
McCook, NE 	USA 	MCK
Macon, GA 	USA 	MCN
Orlando, FL 	USA 	MCO
Mason City, IA 	USA 	MCW
Harrisburg, PA 	USA 	MDT
Chicago, IL 	USA 	MDW
Meridian, MS 	USA 	MEI
Memphis, TN 	USA 	MEM
McAllen, TX 	USA 	MFE
Medford, OR 	USA 	MFR
Montgomery, AL 	USA 	MGM
Morgantown, WV 	USA 	MGW
Manhattan, KS 	USA 	MHK
Manchester, NH 	USA 	MHT
Miami, FL 	USA 	MIA
Milwaukee, WI 	USA 	MKE
Muskegon, MI 	USA 	MKG
Hoolehua, Molokai, HI	USA 	MKK
Jackson, TN 	USA 	MKL
Melbourne, FL 	USA 	MLB
Moline, IL 	USA 	MLI
Miles City, MT	USA 	MLS
Monroe, LA 	USA 	MLU
Mobile, AL 	USA 	MOB
Modesto, CA 	USA 	MOD
Minot, ND 	USA 	MOT
Marquette, MI 	USA 	MQT
Monterey, CA 	USA 	MRY
 Muscle Shoals, AL	USA 	MSL
Madison, WI 	USA 	MSN
Missoula, MT 	USA 	MSO
Minneapolis, MN 	USA 	MSP
Massena, NY 	USA 	MSS
New Orleans, LA 	USA 	MSY
Montrose, CO 	USA 	MTJ
Martha's Vineyard, MA 	USA 	MVY
Marion, IL 	USA 	MWA
Moses Lake, WA	USA 	MWH
Myrtle Beach, SC 	USA 	MYR
New York, NY 	USA 	NYC 
Jacksonville, NC 	USA 	OAJ
Oakland, CA 	USA 	OAK
Kahului, Maui, HI 	USA 	OGG
Ogdensburg, NY 	USA 	OGS
Oklahoma City, OK 	USA 	OKC
Wolf Point, MT	USA 	OLF
Columbus, NE 	USA 	OLU
Omaha, NE 	USA 	OMA
Nome, AK 	USA 	OME
Ontario, CA 	USA 	ONT
Toksook Bay, AK 	USA 	OOK
Chicago, IL 	USA 	ORD
Norfolk, VA 	USA 	ORF
Oshkosh, WI 	USA 	OSH
North Bend, OR 	USA 	OTH
Owensboro, KY 	USA 	OWB
Oxnard, CA 	USA 	OXR
Paducah, KY 	USA 	PAH
West Palm Beach, FL 	USA 	PBI
Pendleton, OR 	USA 	PDT
Portland, OR 	USA 	PDX
Panama City, FL 	USA 	PFN
Page, AZ	USA 	PGA
Greenville, NC 	USA 	PGV
Newport News, VA 	USA 	PHF
Philadelphia, PA 	USA 	PHL
Phoenix, AZ 	USA 	PHX
Peoria, IL 	USA 	PIA
Laurel, MS 	USA 	PIB
St. Petersburg, FL 	USA 	PIE
Pocatello, ID 	USA 	PIH
Pierre, SD 	USA 	PIR
Pittsburgh, PA 	USA 	PIT
Parkersburg, WV 	USA 	PKB
Plattsburgh, NY 	USA 	PLB
Pellston, MI 	USA 	PLN
Ponca City, OK 	USA 	PNC
Pensacola, FL 	USA 	PNS
Presque Isle, ME 	USA 	PQI
Prescott, AZ 	USA 	PRC
Pasco, WA 	USA 	PSC
Portsmouth, NH 	USA 	PSM
Palm Springs, CA 	USA 	PSP
Pueblo, CO 	USA 	PUB
Pullman, WA 	USA 	PUW
Provincetown, MA 	USA 	PVC
Providence, RI 	USA 	PVD
Portland, ME 	USA 	PWM
Los Angeles, CA 	USA 	QLA
San Francisco, CA 	USA 	QSF 
Rapid City, SD 	USA 	RAP
Redding, CA 	USA 	RDD
Redmond, OR 	USA 	RDM
Raleigh, NC 	USA 	RDU
Rockford, IL 	USA 	RFD
Rhinelander, WI	USA 	RHI
Richmond, VA 	USA 	RIC
Riverton, WY 	USA 	RIW
Rockland, ME 	USA 	RKD
Rock Springs, WY 	USA 	RKS
Reno, NV 	USA 	RNO
Roanoke, VA 	USA 	ROA
Rochester, NY 	USA 	ROC
Roswell, NM 	USA 	ROW
Rochester, MN 	USA 	RST
Fort Myers, FL 	USA 	RSW
Rutland, VT 	USA 	RUT
Santa Fe, NM 	USA 	SAF
San Diego, CA 	USA 	SAN
San Antonio, TX 	USA 	SAT
Savannah, GA 	USA 	SAV
Santa Barbara, CA 	USA 	SBA
South Bend, IN 	USA 	SBN
San Luis Obispo, CA 	USA 	SBP
Steamboat Springs, CO 	USA 	SBS
Salisbury, MD 	USA 	SBY
State College, PA 	USA 	SCE
Louisville, KY, USA 	USA 	SDF
Sand Point, AK 	USA 	SDP
Sidney, MT 	USA 	SDY
Seattle, WA 	USA 	SEA
San Francisco, CA 	USA 	SFO
Springfield, MO 	USA 	SGF
St. George, UT 	USA 	SGU
Skagway, AK 	USA 	SGY
Shenandoah Valley Airport, VA 	USA 	SHD
Sheridan, WY 	USA 	SHR
Shreveport, LA 	USA 	SHV
Sitka, AK 	USA 	SIT
San Jose, CA 	USA 	SJC
San Angelo, TX 	USA 	SJT
Salt Lake City, UT 	USA 	SLC
Saranac Lake, NY 	USA 	SLK
Salina, KS 	USA 	SLN
Sacramento, CA 	USA 	SMF
Santa Maria, CA 	USA 	SMX
Orange County, CA 	USA 	SNA
Pinehurst, NC 	USA 	SOP
Springfield, IL 	USA 	SPI
Wichita Falls, TX 	USA 	SPS
Sarasota, FL 	USA 	SRQ
St. Cloud, MN 	USA 	STC
St. Louis, MO 	USA 	STL
Santa Rosa, CA 	USA 	STS
Sun Valley, ID 	USA 	SUN
Sioux City, IA 	USA 	SUX
Silver City, NM 	USA 	SVC
Newburgh, NY 	USA 	SWF
Syracuse, NY 	USA 	SYR
Fort Leonard Wood, MO	USA 	TBN
Telluride, CO	USA 	TEX
Tallahassee, FL 	USA 	TLH
Toledo, OH 	USA 	TOL
Topeka, KS 	USA 	TOP
Tampa, FL 	USA 	TPA
Tri-City Airport, TN 	USA 	TRI
Trenton, NJ 	USA 	TTN
Tulsa, OK 	USA 	TUL
Tupelo, MS 	USA 	TUP
Tucson, AZ 	USA 	TUS
Traverse City, MI 	USA 	TVC
Thief River Falls, MN 	USA 	TVF
Twin Falls, ID 	USA 	TWF
Texarkana, AR 	USA 	TXK
Tyler, TX 	USA 	TYR
Knoxville, TN 	USA 	TYS
Quincy, IL 	USA 	UIN
Unalakleet, AK 	USA 	UNK
Victoria, TX 	USA 	VCT
Valdez, AK 	USA 	VDZ
Visalia, CA 	USA 	VIS
Valdosta, GA 	USA 	VLD
Fort Walton Beach, FL 	USA 	VPS
Springfield, VT 	USA 	VSF
Washington DC 	USA 	WAS
Enid, OK 	USA 	WDG
Wrangell, AK 	USA 	WRG
Worland, WY 	USA 	WRL
West Yellowstone, MT	USA 	WYS
Fayetteville, AR 	USA 	XNA
Yakutat, AK 	USA 	YAK
Yakima, WA 	USA 	YKM
Yuma, AZ 	USA 	YUM
Tashkent	Uzbekistan	TAS
Termez	Uzbekistan	TMJ
Port Vila, Efate Island	Vanuatu	VLI
Ciudad Bolivar	Venezuela	CBL
Caracas	Venezuela	CCS
Maracaibo	Venezuela	MAR
Ban Me Thuot	Vietnam	BMV
Da Nang	Vietnam	DAD
Dien-Bien-Phu	Vietnam	DIN
Hanoi	Vietnam	HAN
Hue	Vietnam	HUI
Pleiku	Vietnam	PXU
Ho Chi Minh City (Saigon)	Vietnam	SGN
Vinh City	Vietnam	VII
Rach Gia	Vietnam	VKG
Cardiff	Wales	CWL
Aden	Yemen	ADE
Sanaa	Yemen	SAH
Lubumbashi	Zaire	FBM
Kinshasa	Zaire	FIH
Kisangani	Zaire	FKI
Lusaka	Zambia	LUN
Bulawayo	Zimbabwe	BUQ
Harare	Zimbabwe	HRE
